11111111111111111111111111111
10100100001000001000010000011
10111111101000001110010000011
1E0000000000000C1000110000001
11100101011000001111110000011
10000000011000000000000000001
1P0000010C00C0000000000000001
11100101000000001010010000011
11111111111111111111111111111