111111111111
1011000000C1
110000001111
10P111E0C001
111111111111